Арахнофобия - боязнь пауков.
Отсутствует.
Клаустрофобия - боязнь закрытых пространств и помещений.
Отсутствует.
Декстрофобия — боязнь вещей расположенных справа.
Отсутствует.
Термофобия - Боязнь жары и натопленных помещений.
Отсутствует.
Агирофобия - боязнь улиц.
Венерофобия - боязнь заболеть венерической болезнью.
Отсутствует.
Авиафобия - боязнь полетов.
Педиофобия - боязнь предметов имитирующих человеческий облик.
Отсутствует.
Эротофобия - боязнь секса.
Базофобия - боязнь ходьбы.
Отсутствует.
Теофобия - боязнь бога.
Мизофобия - боязнь заразиться инфекционным заболеванием.
Отсутствует.
Гамофобия - боязнь вступить в брак.
Отсутствует.
Агорафобия - боязнь открытых мест и пространств.
Акрофобия - боязнь высоты.
Отсутствует.
Токсикофобия - боязнь отравления.
Скабиофобия - боязнь заболеть чесоткой.
Отсутствует.
Аэроэмфиземофобия - боязнь кессонной болезни.
Гипнофобия - боязнь заснуть.
Отсутствует.
Танатофобия - боязнь смерти.
Пирофобия - боязнь огня и пожаров.
Отсутствует.
Спермофобия - боязнь микробов.
Тетрафобия - боязнь числа 4.
Филофобия - боязнь влюбиться.
Отсутствует.
Ранидофобия - боязнь лягушек.
Отсутствует.Некрофобия - боязнь трупов и похоронных принадлежностей.
Отсутствует.
Аграфобия - боязнь сексуальных домогательств, секса.
Децидофобия — боязнь принимать решения.
Демонофобия (cатанофобия) — боязнь Дьявола, демонов и другой нечистой силы.
Дорофобия — боязнь получать или делать подарки.
Отсутствует.
Зоофобия — боязнь животных.
Земмифобия — боязнь кротов.
Инсектофобия — боязнь насекомых; частный случай зоофобии.
Иофобия — боязнь ядов.
Отсутствует.
Виргинитифобия (Virginitiphobia) — боязнь изнасилования.
Текстофобия (Textophobia) — боязнь тканей.
Металлофобия (Metallophobia) — боязнь металлических предметов.
Отсутствует.
Малевзиофобия (Maleusiophobia) — страх перед родами.
Электрофобия (Electrophobia) — боязнь электричества.
Отсутствует.
Фотофобия (Photophobia) — боязнь света.
Метрофобия (Metrophobia) — боязнь поэзии.
Отсутствует.
Херофобия (Cherophobia) — боязнь веселья.
Погонофобия (Pogonophobia) — боязнь бородатых (страх перед бородами).
Отсутствует.
Патройофобия (Patroiophobia) — боязнь наследственности.
Отсутствует.Аклиофобия — боязнь глухоты.
Ангинофобия — боязнь приступа стенокардии.
Блаптофобия — боязнь нанести кому-либо повреждение.
Отсутствует.
Бронтофобия — боязнь грома.
Гелотофобия — страх оказаться объектом юмора, насмешек.
Гнозиофобия (эпистемофобия) — боязнь знания/познания.
Отсутствует.
Отсутствует.
Гидрозофобия — боязнь вспотеть.
Гидрофобия (аквафобия) — боязнь воды, сырости, жидкостей.
Графофобия — боязнь писать или брать в руки письменные принадлежности.
Клептофобия — боязнь украсть, либо страх быть обокраденным.
Отсутствует.
Акрофобия — страх высоты.
Канцерофобия — боязнь заболевания раком.
Отсутствует.
Ахлуофобия (никтофобия, скотофобия, эклуофобия) — боязнь темноты, ночи.
Аутофобия — страх одиночества.
Апопатофобия — боязнь заходить в туалеты.
Вакцинофобия — боязнь прививок и связанных с ними неврологических осложнений.
Отсутствует.
Отсутствует.
Отсутствует.
Верминофобия — боязнь бактерий, микробов, червей, заразиться.
Герпетофобия — боязнь рептилий, пресмыкающихся, змей.
Гомофобия—боязнь любого проявления гомосексуальности.
Айхмофобия — боязнь острых предметов.
Робофобия — страх по отношению к любой робототехнике.
Аматофобия — боязнь пыли.
Отсутствует.
Фазмофобия — боязнь призраков и духов.
Айлурофобия — боязнь кошек.
Айхмофобия — боязнь острых предметов.
Акарофобия — боязнь клещей.
Акнефобия — боязнь появления угрей (акне).
Акротомофобия — боязнь ампутации.
Отсутствует.
Алгофобия — боязнь боли.
Аутомизофобия — боязнь загрязнить своё тело.
Антофобия — боязнь цветов.
Отсутствует.
Анемофобия — боязнь бури (сильного ветра).
Астрофобия — боязнь звёзд и звёздного пространства.
Баллистофобия — боязнь поражения пулей, бомбой или снарядом.
Отсутствует.
Винофобия — боязнь употребления винаВертигофобия (динофобия) — боязнь головокружения.
Гаптофобия — боязнь прикосновения окружающих людей.
Отсутствует.